EXPERIMENT_ID	53_Mf10_LPFi_Ci_input_B_1
SAMPLE_ID	53_Mf10_LPFi_Ci
TECHNICAL_REPLICATE_ID	no technical replicate
BIOLOGICAL_REPLICATE_ID	NO
CONTACT_PERSON	Na Li(nali@molgen.mpg.de)
CONTACT_LAB	Epigenomics Lab at the Max Planck Institute for Molecular Genetics
EXPERIMENT_DATE	6/23/2015
EXPERIMENT_TYPE	ChIP-seq
EXTRACTION_PROTOCOL	Lysis (100mM NaCl, 50 mM Tris-HCl pH8.1, 0.2% NaN3, 1%SDS, 3% Triton X-100) dilution for sonification to 0.33% SDS with (50 mM Tris-HCl pH8.6, 100mM NaCl, 5mM EDTA pH 8.0, 0.2% NaN3)
EXTRACTION_PROTOCOL_STARTING_NR_CELLS	2x10^6
EXTRACTION_PROTOCOL_SONICATION_FRAGMENT_SIZE_RANGE	150-400
BISULFITE_CONVERSION_PROTOCOL	[MISSING]
LIBRARY_GENERATION_ADAPTOR_LIGATION_PROTOCOL	NEBNext® Ultra DNA Library Prep Kit for Illumina® (E7370S/L)
LIBRARY_GENERATION_ADAPTOR_SEQUENCE	5´-/5Phos/GAT CGG AAG AGC ACA CGT CTG AAC TCC AGT C/ideoxyu/A CAC TCT TTC CCT ACA CGA CGC TCT TCC GAT C*T-3´
LIBRARY_GENERATION_PROTOCOL	refer to manufacturer instruction
LIBRARY_GENERATION_INITIAL_INPUT_QNTY	5 ng
LIBRARY_GENERATION_PCR_F_PRIMER_SEQUENCE	5'-AAT GAT ACG GCG ACC ACC GAG ATC TAC ACT CTT TCC CTA CAC GAC GCT CTT CCG ATC*T-3'
LIBRARY_GENERATION_PCR_NUMBER_CYCLES	10
LIBRARY_GENERATION_PCR_POLYMERASE_TYPE	Q5 ® High-Fidelity DNA Polymerase
LIBRARY_GENERATION_PCR_PRIMER_CONC	not given in the protocol
LIBRARY_GENERATION_PCR_PRODUCT_ISOLATION_PROTOCOL	Agencourt AMPure XP Beads (Beckman Coulter)
LIBRARY_GENERATION_PCR_R_PRIMER_SEQUENCE	Index 1 Primer5´-CAAGCAGAAGACGGCATACGAGATCGTGATGTGACTGGAGTTCAGACGTGTGCTCTTCCGATC-s-T-3´
LIBRARY_GENERATION_PCR_TEMPLATE_CONC	N/A
LIBRARY_GENERATION_PCR_THERMOCYCLING_PROGRAM	4 Steps: 1 Cycle: 98°C for 30 sec; 10 Cycles: 98°C for 10 sec, 65°C for 30 sec, 72°C for 30sec;1Cycles: 72°C for 5 min; Hold at 4°C
LIBRARY_GENERATION_PCR_PRODUCT_LENGTH	200-600
LIBRARY_GENERATION_FRAGMENT_SIZE_SELECTION	0.56 AMPure XP Bead mixture (to remove fragments greater than 1000bp) and 0.95AMPure XP Bead mixture (to remove fragments smaller than 200bp)
LIBRARY_GENERATION_cDNA_FRAGMENTATION	N/A
CHIP_PROTOCOL	Auto Histone ChIP Kit (Diagenode)
CHIP_PROTOCOL_CHROMATIN_AMOUNT	32,000cells/input
CHIP_ANTIBODY	N/A
CHIP_ANTIBODY_CATALOG	N/A
CHIP_ANTIBODY_LOT	N/A
CHIP_ANTIBODY_PROVIDER	N/A
CHIP_PROTOCOL_ANTIBODY_AMOUNT	N/A
CHIP_PROTOCOL_BEAD_AMOUNT	N/A
CHIP_PROTOCOL_BEAD_TYPE	N/A
CHIP_PROTOCOL_PERC_CH2O_CROSSLINKING	1% formaldehyde
CHIP_PROTOCOL_DURATION_CROSSLINKING	5 min
CHIP_PROTOCOL_SHEARING_METHOD	bioruptor pico
CHIP_PROTOCOL_SHEARING_CYCLES	2 x 9 cycles of 30 seconds ON, 30 seconds OFF
CHIP_PROTOCOL_SHEARING_FREQUENCY	High frequency
CHIP_PROTOCOL_IPSTAR_CONDITIONS	N/A
ChromatinAccessibility_METHOD	[MISSING]
ChromatinAccessibility_PROTOCOL	[MISSING]
ChromatinAccessibility_CHROMATIN_AMOUNT	[MISSING]
ChromatinAccessibility_ENZYME	[MISSING]
ChromatinAccessibility_ENZYME_PROVIDER	[MISSING]
ChromatinAccessibility_ENZYME_LOT	[MISSING]
ChromatinAccessibility_CHROMATIN_STATUS	[MISSING]
ChromatinAccessibility_ENZYME_AMOUNT	[MISSING]
RNA_PROTOCOL_ENRICHMENT	[MISSING]
RNA_cDNA_PREPARATION_INITIAL_RNA_QNTY	[MISSING]
RNA_cDNA_PREPARATION_PCR_NUMBER_CYCLES	[MISSING]
RNA_cDNA_PREPARATION_REVERSE_TRANSCRIPTION_PROTOCOL	[MISSING]
RNA_EXTRACTION_PROTOCOL_FRAGMENTATION	[MISSING]
RNA_PREPARATION_FRAGMENT_SIZE_RANGE	[MISSING]
RNA_PREPARATION_INITIAL_QNTY	[MISSING]
RNA_EXTRACTION_PROTOCOL	[MISSING]
RNA_PREPARATION_3'_RNA_ADAPTER_LIGATION_PROTOCOL	[MISSING]
RNA_PREPARATION_3'_RNA_ADAPTER_SEQUENCE	[MISSING]
RNA_PREPARATION_5'_DEPHOSPHORYLATION	[MISSING]
RNA_PREPARATION_5'_PHOSPHORYLATION	[MISSING]
RNA_PREPARATION_5'_RNA_ADAPTER_LIGATION_PROTOCOL	[MISSING]
RNA_PREPARATION_5'_RNA_ADAPTER_SEQUENCE	[MISSING]
RNA_PREPARATION_REVERSE_TRANSCRIPTION_PRIMER_SEQUENCE	[MISSING]
RNA_PREPARATION_REVERSE_TRANSCRIPTION_PROTOCOL	[MISSING]
