CONTACT_PERSON	Madlen Sohn (madlen.sohn@mdc-berlin.de)
CONTACT_LAB	MDC
SAMPLE_ID	43_Hm01_BlMo_Ct
EXPERIMENT_DATE	2013-09-26
EXPERIMENT_ID	43_Hm01_BlMo_Ct_snRNA_M_1
EXPERIMENT_TYPE	small RNA-Seq
TECHNICAL_REPLICATE_ID	0
FULL_LENGTH_PROTOCOL_LINK	http://supportres.illumina.com/documents/documentation/chemistry_documentation/samplepreps_truseq/truseqsmallrna/truseq_smallrna_sampleprep_guide_15004197_e.pdf
BIOLOGICAL_REPLICATE_ID	0
EXTRACTION_PROTOCOL	TRIzol RNA Isolation for Cells. TRIzol (Life Technologies) RNA Isolation, performed following the manufacturer instruction to isolate total RNA, used 1 ml TRIzol per Sample. Followed by Isopropyl alcohol/Ethanol precipitation
EXTRACTION_PROTOCOL_STARTING_NR_CELLS	UKN
LIBRARY_GENERATION_PROTOCOL	Ilumina TrueSeq
LIBRARY_GENERATION_INITIAL_INPUT_QNTY	1 µg total RNA
LIBRARY_GENERATION_PCR_F_PRIMER_SEQUENCE	5'-GUUCAGAGUUCUACAGUCCGACGAUC
LIBRARY_GENERATION_PCR_NUMBER_CYCLES	15
LIBRARY_GENERATION_PCR_POLYMERASE_TYPE	From mastermix of TruSeq stranded mRNA kit
LIBRARY_GENERATION_PCR_PRODUCT_ISOLATION_PROTOCOL	Gel.excision, 145-160 bp fraction
LIBRARY_GENERATION_PCR_R_PRIMER_SEQUENCE	5' CAAGCAGAAGACGGCATACGAGATAAGCTAGTGACTGGAGTTCCTTGGCACCCGAGAATTCCA
LIBRARY_GENERATION_PCR_TEMPLATE_CONC	1 µg total RNA
LIBRARY_GENERATION_PCR_THERMOCYCLING_PROGRAM	30s 98ºC, [10s 98ºC, 30s 60ºC, 15s 72ºC] XXX cycles, 10 min 72ºC, hold 4ºC
LIBRARY_GENERATION_PCR_PRODUCT_LENGTH	140
LIBRARY_GENERATION_FRAGMENT_SIZE_SELECTION	140 bp
RNA_PROTOCOL_ENRICHMENT	miRNA
RNA_cDNA_PREPARATION_INITIAL_RNA_QNTY	1 µg total RNA
RNA_cDNA_PREPARATION_PCR_NUMBER_CYCLES	0
RNA_cDNA_PREPARATION_REVERSE_TRANSCRIPTION_PROTOCOL	16°C for 1h
RNA_EXTRACTION_PROTOCOL	Trizol
RNA_PREPARATION_INITIAL_QNTY	1 µg total RNA
RNA_PREPARATION_3'_RNA_ADAPTER_LIGATION_PROTOCOL	according to Illumina TruSeq small RNA protocol
RNA_PREPARATION_3'_RNA_ADAPTER_SEQUENCE	according to Illumina TruSeq small RNA protocol
RNA_PREPARATION_5'_DEPHOSPHORYLATION	according to Illumina TruSeq small RNA protocol
RNA_PREPARATION_5'_PHOSPHORYLATION	according to Illumina TruSeq small RNA protocol
RNA_PREPARATION_5'_RNA_ADAPTER_LIGATION_PROTOCOL	according to Illumina TruSeq small RNA protocol
RNA_PREPARATION_5'_RNA_ADAPTER_SEQUENCE	according to Illumina TruSeq small RNA protocol
RNA_PREPARATION_REVERSE_TRANSCRIPTION_PRIMER_SEQUENCE	according to Illumina TruSeq small RNA protocol
RNA_PREPARATION_REVERSE_TRANSCRIPTION_PROTOCOL	according to Illumina TruSeq small RNA protocol
SEQUENCING_PLATFORM	Illumina HiSeq 2500
SEQUENCING_PLATFORM_VERSION	2000
SEQUENCING_CYCLES	51
SEQUENCING_PE_TYPE	Single-end
SEQUENCING_LANE	5
SEQUENCING_DATE	2013-10-18
SEQUENCING_RUN_TYPE	Multiplexed SR 1x51 + 7 Index
SEQUENCING_CHEMISTRY_VERSION	TruSeq 50 cycle kit v3
SEQUENCING_CLUSTER_GENERATION_KIT_VERSION	SR TruSeq Cluster Kit v3
SEQUENCING_PROCESSING_SOFTWARE_VERSION	CASAVA 1.8.2
SEQUENCING_CONTROL_SOFTWARE_VERSION	HCS 2.0.5 / RTA 1.17.20/ Recipe Fragment: 1.3.55
