DEEP_SAMPLE_ID	43_Hm05_BlMa_Ct
ORGANISM	Homo sapiens
POOL	no
STATUS	control
DISEASE	healthy
BIOMATERIAL_PROVIDER	Stefan Wallner/Regensburg University Hospital
BIOMATERIAL_TYPE	primary cell culture
CELL_TYPE	macrophage
TISSUE_TYPE	blood
MARKERS	[MISSING]
CULTURE_CONDITIONS	6d MCSF
DONOR_ID	43_Hm05
DONOR_AGE	25
DONOR_AGE_UNIT	year
DONOR_HEALTH_STATUS	healthy
DONOR_SEX	male
DONOR_ETHNICITY	caucasian
PASSAGE_IF_EXPANDED	NA
COMMENT	Apo E3/E3 genotype
SORTING_PARAMETERS	NA
