EXPERIMENT_ID	51_Hf01_BlCM_Ct_H3K4me1_B_1
SAMPLE_ID	51_Hf01_BlCM_Ct
TECHNICAL_REPLICATE_ID	1
BIOLOGICAL_REPLICATE_ID	NO
CONTACT_PERSON	Sarah Kinkley (kinkley@molgen.mpg.de) Na Li (nali@molgen.mpg.de) Ho-Ryun Chung (chung@molgen.mpg.de)
CONTACT_LAB	Epigenomics Lab at the Max Planck Institute for Molecular Genetics
EXPERIMENT_DATE	2013-09-17
EXPERIMENT_TYPE	ChIP-seq
EXTRACTION_PROTOCOL	Lysis (100mM NaCl, 50 mM Tris-HCl pH8.1, 0.2% NaN3, 1%SDS, 3% Triton X-100) dilution for sonification to 0.33% SDS with (50 mM Tris-HCl pH8.6, 100mM NaCl, 5mM EDTA pH 8.0, 0.2% NaN3)
EXTRACTION_PROTOCOL_STARTING_NR_CELLS	N/A
EXTRACTION_PROTOCOL_SONICATION_FRAGMENT_SIZE_RANGE	N/A
BISULFITE_CONVERSION_PROTOCOL	N/A
LIBRARY_GENERATION_ADAPTOR_LIGATION_PROTOCOL	N/A
LIBRARY_GENERATION_ADAPTOR_SEQUENCE	5’ AATGATACGGCGACCACCGAGATCTACACTCTTTCCCTACACGACGCTCTTCCGATCT---Insert---AGATCGGAAGAGCACACGTCTGAACTCCAGTCACCGATGTATCTCGTATGCCGTCTTCTGCTTG 3’ 3’ TTACTATGCCGCTGGTGGCTCTAGATGTGAGAAAGGGATGTGCTGCGAGAAGGCTAGA---Insert---TCTAGCCTTCTCGTGTGCAGACTTGAGGTCAGTGGCTACATAGAGCATACGGCAGAAGACGAAC 5’
LIBRARY_GENERATION_PROTOCOL	Diagenode µ-Plex Library kit
LIBRARY_GENERATION_INITIAL_INPUT_QNTY	N/A
LIBRARY_GENERATION_PCR_F_PRIMER_SEQUENCE	Universal PCR Primer for Illumina 5'-AATGATACGGCGACCACCGAGATCTACACTCTTTCCCTACACGACGCTCTTCCGATC*T-3'
LIBRARY_GENERATION_PCR_NUMBER_CYCLES	12
LIBRARY_GENERATION_PCR_POLYMERASE_TYPE	similar or better than KAPA HiFi polymerase
LIBRARY_GENERATION_PCR_PRIMER_CONC	not given in the protocol
LIBRARY_GENERATION_PCR_PRODUCT_ISOLATION_PROTOCOL	Agencourt AMPure XP Beads (Beckman Coulter, A63881)
LIBRARY_GENERATION_PCR_R_PRIMER_SEQUENCE	Index 2 Primer 5´-CAAGCAGAAGACGGCATACGAGATACATCGGTGACTGGAGTTCAGACGTGTGCTCTTCCGATC-s-T-3´
LIBRARY_GENERATION_PCR_TEMPLATE_CONC	4 ng
LIBRARY_GENERATION_PCR_THERMOCYCLING_PROGRAM	6 Steps: 1 Cycle: 72°C for 3 min; 1 Cycle: 85°C for 2 min; 1 Cycle: 98°C for 2 min; 4 Cycles: 98°C for 20 sec, 67°C 20 sec, 72°C for 50sec;12 Cycles: 98°C for 20 sec, 72°C for 50 sec; Hold at 4°C
LIBRARY_GENERATION_PCR_PRODUCT_LENGTH	Fragment size distribution from 200 bp to 600 bp
LIBRARY_GENERATION_FRAGMENT_SIZE_SELECTION	0.5 AMPure XP Bead mixture (to remove fragments greater than 1000bp) and 0.85AMPure XP Bead mixture (to remove fragments smaller than 200bp)
LIBRARY_GENERATION_cDNA_FRAGMENTATION	N/A
CHIP_PROTOCOL	Auto Histone ChIP Kit (Diagenode). Indirect method. ChIP_16_IPure_200_15h antibody incubation and 10h bead incubation 5 min washes. Decrosslink ON at 65°C; Rnase A 30 min at 37°C; Proteinase K treatment 4 h at 55°C. Purification by Phenol Chloroform Extraction and ON precipitation
CHIP_PROTOCOL_CHROMATIN_AMOUNT	15,8 ng from 200,000 cells
CHIP_ANTIBODY	H3K4me1
CHIP_ANTIBODY_CATALOG	pAb-194-050
CHIP_ANTIBODY_LOT	A1863-001D
CHIP_ANTIBODY_PROVIDER	Diagenode
CHIP_PROTOCOL_ANTIBODY_AMOUNT	1 µg
CHIP_PROTOCOL_BEAD_AMOUNT	20 µl (although we only used 10 µl beads, but the 20 µl program due to the ChIP volume)
CHIP_PROTOCOL_BEAD_TYPE	magnetic beads A from Auto histone kit (Diagenode)
CHIP_PROTOCOL_PERC_CH2O_CROSSLINKING	N/A
CHIP_PROTOCOL_DURATION_CROSSLINKING	N/A
CHIP_PROTOCOL_SHEARING_METHOD	N/A
CHIP_PROTOCOL_SHEARING_CYCLES	N/A
CHIP_PROTOCOL_SHEARING_FREQUENCY	N/A
CHIP_PROTOCOL_IPSTAR_CONDITIONS	N/A
ChromatinAccessibility_METHOD	N/A
ChromatinAccessibility_PROTOCOL	N/A
ChromatinAccessibility_CHROMATIN_AMOUNT	N/A
ChromatinAccessibility_ENZYME	N/A
ChromatinAccessibility_ENZYME_PROVIDER	N/A
ChromatinAccessibility_ENZYME_LOT	N/A
ChromatinAccessibility_CHROMATIN_STATUS	N/A
ChromatinAccessibility_ENZYME_AMOUNT	N/A
RNA_PROTOCOL_ENRICHMENT	N/A
RNA_cDNA_PREPARATION_INITIAL_RNA_QNTY	N/A
RNA_cDNA_PREPARATION_PCR_NUMBER_CYCLES	N/A
RNA_cDNA_PREPARATION_REVERSE_TRANSCRIPTION_PROTOCOL	N/A
RNA_EXTRACTION_PROTOCOL_FRAGMENTATION	N/A
RNA_PREPARATION_FRAGMENT_SIZE_RANGE	N/A
RNA_PREPARATION_INITIAL_QNTY	N/A
RNA_EXTRACTION_PROTOCOL	N/A
RNA_PREPARATION_3'_RNA_ADAPTER_LIGATION_PROTOCOL	N/A
RNA_PREPARATION_3'_RNA_ADAPTER_SEQUENCE	N/A
RNA_PREPARATION_5'_DEPHOSPHORYLATION	N/A
RNA_PREPARATION_5'_PHOSPHORYLATION	N/A
RNA_PREPARATION_5'_RNA_ADAPTER_LIGATION_PROTOCOL	N/A
RNA_PREPARATION_5'_RNA_ADAPTER_SEQUENCE	N/A
RNA_PREPARATION_REVERSE_TRANSCRIPTION_PRIMER_SEQUENCE	N/A
RNA_PREPARATION_REVERSE_TRANSCRIPTION_PROTOCOL	N/A
